Malik Nabers	LSU
Rome Odunze	Washington
Ricky Pearsall	Florida
Ja'Lynn Polk	Washington
Brenden Rice	USC
Tayvion Robinson	Kentucky
Marcus Rosemy-Jacksaint	Georgia
Ainias Smith	Texas A&M
Brian Thomas Jr.	LSU
Jamari Thrash	Louisville
Devaughn Vele	Utah
Devontez Walker	North Carolina
Malik Washington	Virginia
Tahj Washington	USC
Xavier Weaver	Colorado
Jordan Whittington	Texas
Isaiah Williams	Illinois
Johnny Wilson	Florida State
Roman Wilson	Michigan
Xavier Worthy	Texas
Marvin Harrison Jr.	Ohio State